*******************
*     *    *      *
* *** * ** * **** *
* *   *  * *    * *
* * *** ** **** * *
* * *       *   * *
* * * ***** *** * *
* * *   * * *   * *
* * *** * * * *** *
* *   * *   *   * *
* *** * ***** *** *
*   * *     *     *
* *** *** *** *** *
*     *     *   * *
* ***** ***** *** *
*   *     *     * *
* * * ***** ***** *
* * *   *     *   *
* ***** *** ***** *
*                 *
*******************

