***********************************************
*     *       *     *   *             *       *
* *** * ***** * *** * * * *** ***** * * *** * *
* *   *     *   *     *   *   *   *   *     * *
* * ***** **** ** ***** ***** * * * *** ***** *
* *     * *           *     * * *     *   *   *
* ***** * * *** ***** * *** *** ***** *** *** *
*     *   *   * *   *   *   *   *   *     *   *
*** ***** *** * * ***** *** *** * ******* *** *
*   *   *     * *   *   *     * *   *   * *   *
* *** * ** **** *** * *** * *** * * *   * * ***
*     *     *     *   *   *     * * *   * *   *
***** ***** * ***** *** ***** *** * ** ** *** *
*   *   *   * *     *   *     *   * *   *   * *
* * *** * *** * ***** *** *** *** * * ***** * *
* *   * *   * *     *       *       *     * * *
* *** * *** * ***** * *** *** ***** *****   * *
*                       *         *           *
***********************************************
