########################################
#       #                 #            #
### ### ### ##### ### ### # # # ### # ##
#   #     #     # #     # # # #   # #  #
# ##### ####### # ##### ### ##### ### ##
#   #   #     #   #   #     #   #     ##
### # ### ### ##### ####### ### ### ####
#   #     #     #         #   #   #    #
# ####### ##### # ### ### ### ### #### #
#       #     # #   #   #     #   #    #
# ####### ### # ##### ####### # ### ## #
#         #   #         #     #        #
########################################

