********************
*     *     *      *
* *** ***** *** ****
*   *     * *      *
*** * ***** * * * **
*   *     * * * *  *
* ******* * *** ****
* *     * *        *
* * *** * ***** * **
* * *   *     * *  *
* * *** ***** * ****
* *   * *   * *    *
* *** * *** * ** ***
*     *     *      *
* ******* ******* **
*   *     *        *
*** *** *** ********
*     *            *
********************

